1111111111111111111111111111111111
1000000CC000000C00000C000000C00001
10100101P0100000101001000C00010101
10100100101010100010010000C0010101
100000000C00C000100000C00100C000E1
1111111111111111111111111111111111