1111111111111111111111111111111111111111
1E0000C001111110CC00000111110000C0000CC1
10001110000C00011111C0C0C0000C0001111111
11001100000C000C00C000C000C000C00C011001
100C111111000C01CCC111110000C0000CC00001
11000001111C000C000C0000C00C111000111001
1000P000C00C000C0000111110C00000C0000001
1111111111111111111111111111111111111111