111111111111111111111111111111111111111111111
1E00000000CC01000C00010000CC0000N00000CC000N1
10111C0N00010001000C000010000N0000100001000C1
1100N000C00010000CC1000N0001000CC000N00CC1001
100100C00C000001000N000100N000C000111N00000C1
1N00001000CC0000N001000CCC0001000C000001000C1
11CC000010001000100N000CN001000010C00C0001001
10111C0N00010001000C000010000N0000100001000C1
100000P00010000C000C000N00000C0N00010000C1001
111111111111111111111111111111111111111111111