111111111111111111111111111111111111111
100C100C100C100C100C100C100C100C100C101
10100C100C100C100C100C100C100C100C100C1
111111111111111111001111111111111111101
100C100C100C100C100C100C100C100C100C101
1C100C100C100C100C100C100C100C100C100C1
10000000000000N000000000000000000000011
100C100C100C100C100C100C100C100C100C101
1C100C100C100C100C100C100C100C100C100C1
111111100111111111111110011111111111101
100C100C100C100C100C100C100C100C100C101
1C100C1N0C100C100C100C100C10NC100C100C1
100000000000E00000N00000000000000000011
100C100C100C100C000C100C100C100C100C101
1C100C100C100C000C000C100C100C100C100C1
11000000N0000000N00000000N00000000N0101
100C100C100CC00C000C000C100C100C000C101
1C100C10NC10PC100C100C100E000C100C100C1
111111111111111111111111111111111111111