1111111111111111111111
100C100C100C100C000001
1E100C10PC100C100EC1N1
1111111111111111111111