111111111111111111111111111111
1P011111C011C001000C0100001111
110000000001110100100001100011
110111011C000100000011N1C01011
11N0000000N0C00010111001100NC1
1C1N1101111100N0100000101N1111
100000N000C0001101110C0001C001
111001111111000000111110111001
10001100C0000001N0C00000000N01
110100010111110001011110100101
11010111010100N00000000011C1C1
11010000110101111000110N100111
1C0000001001110000111011100C11
11N1011N0000C000101C00001N1111
1C0101011111110110110111101001
111101000100010C000100C1000001
100001000011011110010111011N01
1001100100C100000101N00001C011
1010100001011011000C1111111111
1NC00NC0N100C01C00010C00000011
1110011101110001N0011011110001
1N10111C00100N0110N1101C1CN001
101N00110110010011001000111101
100010NC01E1111000000011N1N111
10C01101110000C01N100N000000C1
111111111111111111111111111111