111111111111111111111111111111111111111111111111111
1E000000011111000000CC0000N00000C00000CCC0000111111
10000P0000100000CCCC000001111111111111111000000CCC1
11110000111000CCCC111110000000CCCCC1110000N00110001
100001000000C0000C00000N00001110001111000CCC1110001
10100000C1CC0000111111000000111111000000CCCCN000001
11100011010101010100010101010101C11C1C1C1C11C1C1C11
11111000000CCC00001C1C1C1C0000010110100000000100001
1000C000NN0000C0000000N0N00N000000001111000011C1111
1000111000CCC111NN1111100000100000CC1000C00CC11CC01
101010101010101010101010101010101010101010101010101
1CCCC1000010001100000000000000000000000000000000001
100000000000000000000000000000000000000000000000001
11110000111000CCCC111110000000CCCCC1110000N00110001
100001000000C0000C00000N00001110001111000CCC1110001
10100000C1CC0000111111000000111111000000CCCCN000001
11100011010101010100010101010101C11C1C1C1C11C1C1C11
11111000000CCC00001C1C1C1C0000010110100000000100001
1000C000NN0000C0000000N0N00N000000001111000011C1111
1000111000CCC111NN1111100000100000CC1000C00CC11CC01
101010101010101010101010101010101010101010101010101
1CCCC1000010001100000000000000000000000000000000001
111111111111111111111111111111111111111111111111111